9 3 5 9 7 9 5 8 3 1 3 3 7 9 5 13
10 7 10 4 9 6 10 6 9 0 1 3 3 6 10 6
9 3 5 10 6 9 3 1 4 12 10 3 5 9 3 5
10 5 8 3 3 6 11 4 12 10 3 5 10 6 11 4
9 6 14 9 3 3 5 12 8 1 7 10 3 3 5 14
8 7 9 6 13 9 6 12 12 12 9 3 5 13 10 5
12 9 6 9 6 8 7 12 12 14 12 13 12 10 3 6
12 10 5 10 3 6 9 6 10 5 8 6 8 5 9 5
10 5 12 9 3 7 10 3 5 10 6 9 6 10 6 12
13 8 6 10 1 3 3 3 6 9 5 12 9 3 5 12
12 12 9 5 14 9 3 3 3 6 10 6 10 5 12 12
12 8 6 10 7 12 11 3 5 9 3 3 5 12 10 4
12 10 5 13 13 12 9 3 4 10 5 13 12 12 13 12
12 11 2 6 14 10 6 11 2 7 12 10 4 12 10 6
8 1 3 7 11 3 5 9 3 5 12 13 12 10 3 5
14 10 3 3 3 3 6 10 5 10 6 10 2 3 3 6
